//MAP CONVERTED BY dmm2tgm.py THIS HEADER COMMENT PREVENTS RECONVERSION, DO NOT REMOVE
"ag" = (
/obj/machinery/computer{
	dir = 8;
	pixel_x = -3
	},
/turf/open/floor/plasteel/rivets/large,
/area/hilbertshotel)
"aO" = (
/obj/machinery/door/airlock/centcom,
/turf/open/floor/carpet/red,
/area/hilbertshotel)
"aP" = (
/obj/structure/bed,
/turf/open/floor/wood/wood_tiled,
/area/hilbertshotel)
"br" = (
/turf/open/floor/plasteel/rivets/half{
	dir = 1
	},
/area/hilbertshotel)
"bH" = (
/obj/effect/turf_decal/stripes/corner{
	dir = 1
	},
/turf/open/floor/plasteel/rivets/half{
	dir = 1
	},
/area/hilbertshotel)
"dl" = (
/obj/effect/turf_decal/siding/wood,
/turf/open/floor/wood/wood_large,
/area/hilbertshotel)
"eS" = (
/obj/effect/turf_decal/stripes/corner{
	dir = 4
	},
/obj/effect/decal/cleanable/oil,
/obj/item/mop,
/turf/open/floor/plasteel/rivets/half{
	dir = 1
	},
/area/hilbertshotel)
"fN" = (
/obj/structure/table/reinforced,
/obj/item/toy/cards/deck,
/obj/machinery/light/small{
	dir = 4
	},
/turf/open/floor/plasteel/rivets/corner{
	dir = 8
	},
/area/hilbertshotel)
"gq" = (
/obj/structure/chair/comfy/shuttle{
	dir = 4
	},
/turf/open/floor/plasteel/rivets/half{
	dir = 1
	},
/area/hilbertshotel)
"hA" = (
/obj/machinery/light,
/obj/effect/turf_decal/siding/wood,
/turf/open/floor/wood/wood_large,
/area/hilbertshotel)
"hD" = (
/obj/structure/chair/sofa/corp/right{
	color = "#DE3A3A";
	dir = 8
	},
/turf/open/floor/carpet/red,
/area/hilbertshotel)
"iB" = (
/obj/effect/turf_decal/stripes/line,
/obj/structure/ladder/unbreakable/hotel{
	id = "exit"
	},
/turf/open/floor/plasteel/rivets/half{
	dir = 1
	},
/area/hilbertshotel)
"iJ" = (
/obj/machinery/door/airlock/centcom,
/turf/open/floor/wood/wood_tiled,
/area/hilbertshotel)
"jc" = (
/obj/machinery/light{
	dir = 1
	},
/turf/open/floor/plasteel/stairs/left{
	dir = 8
	},
/area/hilbertshotel)
"jw" = (
/obj/machinery/telecomms/relay/preset/auto,
/turf/open/floor/catwalk_floor,
/area/hilbertshotel)
"kf" = (
/obj/effect/turf_decal/caution{
	dir = 1
	},
/obj/effect/turf_decal/stripes/line,
/obj/structure/ladder/unbreakable/hotel{
	id = "exit"
	},
/turf/open/floor/plasteel/rivets/half{
	dir = 1
	},
/area/hilbertshotel)
"kv" = (
/obj/effect/turf_decal/arrows{
	dir = 4
	},
/obj/structure/ladder/unbreakable/hotel{
	id = "train2";
	pixel_x = 33;
	pixel_y = 0
	},
/obj/structure/ladder/unbreakable/hotel{
	id = "trainloop";
	alpha = 0;
	mouse_opacity = 0;
	pixel_x = 0;
	pixel_y = 0
	},
/turf/open/floor/plasteel/rivets/edge{
	dir = 4
	},
/area/hilbertshotel)
"kY" = (
/obj/structure/chair/pew,
/turf/open/floor/plating/dirt/dark/jungle{
	initial_gas_mix = "o2=21.78;n2=82.36;TEMP=293.15"
	},
/area/hilbertshotel)
"lh" = (
/obj/effect/turf_decal/siding/wood{
	dir = 6
	},
/turf/open/floor/wood/wood_large,
/area/hilbertshotel)
"lj" = (
/obj/machinery/door/airlock/hatch,
/turf/open/floor/plasteel/rivets/large,
/area/hilbertshotel)
"lp" = (
/obj/machinery/light{
	dir = 8
	},
/turf/open/floor/wood/wood_tiled,
/area/hilbertshotel)
"lC" = (
/obj/structure/flora/junglebush,
/turf/open/floor/plating/smooth/grass/lavaland_jungle{
	initial_gas_mix = "o2=21.78;n2=82.36;TEMP=293.15"
	},
/area/hilbertshotel)
"lT" = (
/obj/structure/chair/sofa/corp/left{
	color = "#DE3A3A";
	dir = 8
	},
/obj/effect/turf_decal/siding/wood,
/turf/open/floor/wood,
/area/hilbertshotel)
"mz" = (
/obj/machinery/vending/kink,
/turf/open/floor/plasteel/rivets,
/area/hilbertshotel)
"nb" = (
/obj/machinery/light/small{
	brightness = 3;
	dir = 8
	},
/turf/open/floor/plasteel/rivets/edge{
	dir = 8
	},
/area/hilbertshotel)
"nY" = (
/obj/machinery/light,
/turf/open/floor/plasteel/stairs/right{
	dir = 8
	},
/area/hilbertshotel)
"pd" = (
/turf/open/floor/plasteel/rivets/corner{
	dir = 1
	},
/area/hilbertshotel)
"pM" = (
/obj/effect/turf_decal/caution,
/obj/effect/turf_decal/stripes/line{
	dir = 1
	},
/obj/structure/ladder/unbreakable/hotel{
	id = "exit"
	},
/turf/open/floor/plasteel/rivets/half{
	dir = 1
	},
/area/hilbertshotel)
"pO" = (
/obj/structure/table/reinforced,
/obj/item/reagent_containers/food/drinks/drinkingglass,
/obj/item/reagent_containers/food/drinks/drinkingglass{
	pixel_x = 8;
	pixel_y = 0
	},
/obj/item/reagent_containers/food/drinks/drinkingglass{
	pixel_x = 4;
	pixel_y = 0
	},
/turf/open/floor/plasteel/rivets,
/area/hilbertshotel)
"pR" = (
/obj/structure/flora/rock/jungle,
/turf/open/floor/plating/smooth/grass/lavaland_jungle{
	initial_gas_mix = "o2=21.78;n2=82.36;TEMP=293.15"
	},
/area/hilbertshotel)
"qw" = (
/obj/effect/turf_decal/siding/wood{
	dir = 1
	},
/obj/structure/ladder/unbreakable/hotel{
	id = "trainloop"
	},
/turf/open/floor/wood/wood_large,
/area/hilbertshotel)
"rA" = (
/obj/structure/table/wood/fancy,
/obj/effect/turf_decal/siding/wood,
/turf/open/floor/wood,
/area/hilbertshotel)
"rE" = (
/obj/structure/chair/stool{
	dir = 1;
	pixel_x = 0;
	pixel_y = 14
	},
/obj/machinery/light/small{
	brightness = 3;
	dir = 8
	},
/turf/open/floor/plasteel/rivets,
/area/hilbertshotel)
"sx" = (
/turf/open/floor/plasteel/rivets/half,
/area/hilbertshotel)
"sS" = (
/obj/machinery/vending/boozeomat{
	pixel_x = 32;
	pixel_y = 0;
	density = 0
	},
/obj/effect/turf_decal/siding/wood/corner{
	dir = 8
	},
/turf/open/floor/wood,
/area/hilbertshotel)
"tg" = (
/obj/effect/turf_decal/siding/wood{
	dir = 8
	},
/turf/open/floor/wood,
/area/hilbertshotel)
"we" = (
/obj/item/bedsheet/brown,
/obj/structure/bed/pod,
/turf/open/floor/plasteel/rivets/half,
/area/hilbertshotel)
"xv" = (
/obj/effect/turf_decal/stripes/corner{
	dir = 4
	},
/turf/open/floor/plasteel/rivets/half{
	dir = 1
	},
/area/hilbertshotel)
"yr" = (
/turf/closed/indestructible/fakedoor,
/area/hilbertshotel)
"yU" = (
/obj/effect/turf_decal/siding/wood/corner{
	dir = 1
	},
/turf/open/floor/wood,
/area/hilbertshotel)
"yV" = (
/obj/structure/table/reinforced,
/turf/open/floor/carpet/red,
/area/hilbertshotel)
"zU" = (
/turf/closed/indestructible/syndicate,
/area/hilbertshotel)
"Ah" = (
/obj/structure/chair/comfy/shuttle{
	dir = 8
	},
/turf/open/floor/carpet/red,
/area/hilbertshotel)
"As" = (
/obj/machinery/light,
/obj/effect/turf_decal/siding/wood{
	dir = 1
	},
/turf/open/floor/wood,
/area/hilbertshotel)
"BZ" = (
/obj/structure/table/reinforced,
/turf/open/floor/wood/wood_tiled,
/area/hilbertshotel)
"CC" = (
/obj/structure/chair/sofa/corp/left{
	color = "#DE3A3A";
	dir = 4
	},
/obj/effect/turf_decal/siding/wood{
	dir = 4
	},
/turf/open/floor/wood,
/area/hilbertshotel)
"CR" = (
/turf/open/floor/plasteel/rivets/corner{
	dir = 4
	},
/area/hilbertshotel)
"Dc" = (
/obj/effect/turf_decal/arrows{
	dir = 4
	},
/obj/structure/ladder/unbreakable/hotel{
	id = "train3"
	},
/turf/open/floor/plasteel/rivets/edge{
	dir = 4
	},
/area/hilbertshotel)
"De" = (
/obj/machinery/vending/snack/orange{
	shut_up = 1;
	pixel_x = 5;
	pixel_y = 17;
	density = 0
	},
/obj/machinery/light{
	dir = 1;
	invisibility = 60
	},
/obj/effect/turf_decal/siding/wood,
/turf/open/floor/wood,
/area/hilbertshotel)
"Dl" = (
/turf/closed/indestructible/hoteldoor{
	icon_state = "door_closed";
	icon = 'icons/obj/doors/puzzledoor/default.dmi'
	},
/area/hilbertshotel)
"Dx" = (
/obj/machinery/power/floodlight/lamppost/one{
	dir = 4;
	idle_power_usage = 0;
	lamp_power_usage = 0
	},
/obj/structure/cable,
/turf/open/floor/plating/smooth/grass/lavaland_jungle{
	initial_gas_mix = "o2=21.78;n2=82.36;TEMP=293.15"
	},
/area/hilbertshotel)
"DA" = (
/turf/open/floor/plasteel/rivets/corner{
	dir = 8
	},
/area/hilbertshotel)
"DN" = (
/obj/structure/ladder/unbreakable/hotel{
	id = "exit"
	},
/turf/open/floor/plating/dirt/dark/jungle{
	initial_gas_mix = "o2=21.78;n2=82.36;TEMP=293.15"
	},
/area/hilbertshotel)
"DX" = (
/obj/structure/chair/stool{
	dir = 1;
	pixel_x = 0;
	pixel_y = 14
	},
/turf/open/floor/plasteel/rivets/corner{
	dir = 1
	},
/area/hilbertshotel)
"Ew" = (
/obj/structure/table/reinforced,
/obj/machinery/chem_dispenser/drinks/beer/fullupgrade{
	dir = 4
	},
/obj/effect/turf_decal/siding/wood,
/turf/open/floor/wood,
/area/hilbertshotel)
"Ex" = (
/turf/open/floor/carpet/red,
/area/hilbertshotel)
"Fu" = (
/obj/machinery/light{
	dir = 1
	},
/obj/effect/turf_decal/siding/wood{
	dir = 1
	},
/turf/open/floor/wood/wood_large,
/area/hilbertshotel)
"GU" = (
/obj/structure/chair/stool{
	dir = 4;
	pixel_x = 8;
	pixel_y = 0
	},
/turf/open/floor/plasteel/rivets/corner,
/area/hilbertshotel)
"Hw" = (
/turf/open/floor/plasteel/rivets/edge{
	dir = 8
	},
/area/hilbertshotel)
"HN" = (
/obj/structure/table/reinforced,
/obj/machinery/chem_dispenser/drinks/fullupgrade{
	dir = 4;
	pixel_x = 0;
	pixel_y = 19;
	layer = 2.91
	},
/turf/open/floor/carpet/red,
/area/hilbertshotel)
"Iy" = (
/obj/structure/chair/stool{
	dir = 8;
	pixel_x = -8;
	pixel_y = 0
	},
/turf/open/floor/plasteel/rivets,
/area/hilbertshotel)
"JC" = (
/obj/structure/closet/cabinet,
/turf/open/floor/carpet/red,
/area/hilbertshotel)
"JY" = (
/turf/open/floor/plating/dirt/dark/jungle{
	initial_gas_mix = "o2=21.78;n2=82.36;TEMP=293.15"
	},
/area/hilbertshotel)
"Ld" = (
/obj/effect/turf_decal/siding/wood/corner{
	dir = 4
	},
/obj/structure/ladder/unbreakable/hotel{
	id = "train2"
	},
/turf/open/floor/wood,
/area/hilbertshotel)
"Mt" = (
/obj/effect/turf_decal/siding/wood/corner{
	dir = 1
	},
/obj/effect/turf_decal/siding/wood/corner{
	dir = 4
	},
/turf/open/floor/wood/wood_large,
/area/hilbertshotel)
"MC" = (
/turf/open/floor/plasteel/rivets,
/area/hilbertshotel)
"Ng" = (
/obj/structure/chair/comfy/shuttle{
	dir = 1
	},
/obj/machinery/light{
	dir = 8
	},
/turf/open/floor/carpet/red,
/area/hilbertshotel)
"Nl" = (
/obj/structure/flora/junglebush/c,
/turf/open/floor/plating/smooth/grass/lavaland_jungle{
	initial_gas_mix = "o2=21.78;n2=82.36;TEMP=293.15"
	},
/area/hilbertshotel)
"Og" = (
/obj/structure/closet/crate/bin,
/turf/open/floor/plating/smooth/grass/lavaland_jungle{
	initial_gas_mix = "o2=21.78;n2=82.36;TEMP=293.15"
	},
/area/hilbertshotel)
"Pm" = (
/obj/structure/chair/sofa/corp/left{
	color = "#DE3A3A";
	dir = 4
	},
/turf/open/floor/carpet/red,
/area/hilbertshotel)
"Po" = (
/turf/open/floor/plating/smooth/grass/lavaland_jungle{
	initial_gas_mix = "o2=21.78;n2=82.36;TEMP=293.15"
	},
/area/hilbertshotel)
"Px" = (
/obj/structure/bed/double/pod,
/obj/item/bedsheet/brown/double,
/obj/machinery/light{
	dir = 4
	},
/turf/open/floor/carpet/red,
/area/hilbertshotel)
"PZ" = (
/obj/effect/turf_decal/siding/wood{
	dir = 1
	},
/turf/open/floor/wood,
/area/hilbertshotel)
"Qt" = (
/obj/structure/chair/sofa/corp/right{
	color = "#DE3A3A";
	dir = 4
	},
/obj/effect/turf_decal/siding/wood/corner,
/turf/open/floor/wood,
/area/hilbertshotel)
"QO" = (
/turf/open/floor/plasteel/rivets/corner,
/area/hilbertshotel)
"Su" = (
/obj/structure/chair/pew/right,
/turf/open/floor/plating/dirt/dark/jungle{
	initial_gas_mix = "o2=21.78;n2=82.36;TEMP=293.15"
	},
/area/hilbertshotel)
"Sy" = (
/obj/effect/turf_decal/arrows{
	dir = 8
	},
/obj/structure/ladder/unbreakable/hotel{
	id = "train3"
	},
/turf/open/floor/plasteel/rivets/edge{
	dir = 8
	},
/area/hilbertshotel)
"Tp" = (
/obj/structure/closet,
/turf/open/floor/plasteel/rivets,
/area/hilbertshotel)
"Ty" = (
/obj/structure/table/reinforced,
/obj/item/reagent_containers/food/drinks/flask{
	pixel_x = -8;
	pixel_y = 9
	},
/obj/item/storage/backpack/guitarbag/loaded{
	pixel_x = 4;
	pixel_y = 0
	},
/turf/open/floor/plasteel/rivets/edge{
	dir = 8
	},
/area/hilbertshotel)
"TO" = (
/obj/effect/turf_decal/siding/wood{
	dir = 10
	},
/turf/open/floor/wood/wood_large,
/area/hilbertshotel)
"TX" = (
/obj/structure/chair/stool/bar/directional,
/obj/effect/turf_decal/siding/wood,
/turf/open/floor/wood,
/area/hilbertshotel)
"Uq" = (
/obj/machinery/door/airlock/centcom,
/turf/open/floor/plasteel/rivets,
/area/hilbertshotel)
"Ur" = (
/obj/effect/turf_decal/siding/wood{
	dir = 1
	},
/turf/open/floor/wood/wood_large,
/area/hilbertshotel)
"Vt" = (
/obj/structure/chair/pew/left,
/turf/open/floor/plating/dirt/dark/jungle{
	initial_gas_mix = "o2=21.78;n2=82.36;TEMP=293.15"
	},
/area/hilbertshotel)
"We" = (
/obj/structure/table/wood/fancy,
/turf/open/floor/carpet/red,
/area/hilbertshotel)
"Wx" = (
/obj/structure/chair/sofa/corp/right{
	color = "#DE3A3A";
	dir = 4
	},
/obj/machinery/light{
	dir = 1
	},
/obj/effect/turf_decal/siding/wood,
/turf/open/floor/wood,
/area/hilbertshotel)
"WS" = (
/obj/machinery/vending/games{
	shut_up = 1;
	pixel_x = 16;
	pixel_y = 17;
	density = 0
	},
/obj/effect/turf_decal/siding/wood,
/obj/machinery/jukebox{
	req_one_access = null;
	set_obj_flags = "EMAGGED";
	density = 0;
	pixel_x = -7;
	pixel_y = 18
	},
/turf/open/floor/wood,
/area/hilbertshotel)
"XA" = (
/obj/machinery/light{
	dir = 4
	},
/turf/open/floor/wood/wood_tiled,
/area/hilbertshotel)
"Yd" = (
/turf/open/floor/wood/wood_tiled,
/area/hilbertshotel)
"YF" = (
/obj/item/clothing/suit/caution,
/turf/open/floor/plasteel/rivets/half{
	dir = 1
	},
/area/hilbertshotel)

(1,1,1) = {"
zU
zU
zU
zU
yr
zU
zU
zU
zU
yr
zU
zU
zU
zU
zU
zU
"}
(2,1,1) = {"
zU
pO
rE
zU
qw
TO
zU
Qt
CC
Ld
zU
Nl
Po
Po
lC
zU
"}
(3,1,1) = {"
zU
Iy
MC
Uq
Mt
dl
zU
rA
We
PZ
zU
Po
Dx
Nl
Po
zU
"}
(4,1,1) = {"
zU
Tp
mz
zU
Ur
dl
zU
lT
hD
PZ
zU
pR
Vt
JY
Po
zU
"}
(5,1,1) = {"
zU
zU
zU
zU
Fu
hA
zU
Wx
Pm
As
zU
Po
kY
JY
Po
zU
"}
(6,1,1) = {"
zU
aP
lp
zU
Ur
dl
zU
rA
We
PZ
zU
Po
Su
JY
lC
zU
"}
(7,1,1) = {"
zU
BZ
Yd
iJ
Mt
dl
zU
lT
hD
PZ
zU
Po
Og
JY
JY
Dl
"}
(8,1,1) = {"
zU
aP
XA
zU
Ur
dl
zU
WS
Ex
PZ
zU
DN
JY
JY
Po
zU
"}
(9,1,1) = {"
zU
zU
zU
zU
Fu
hA
zU
De
Ex
As
zU
zU
zU
yr
zU
zU
"}
(10,1,1) = {"
zU
yV
Ng
zU
Ur
dl
zU
Ew
HN
PZ
zU
GU
Hw
Sy
Ty
zU
"}
(11,1,1) = {"
zU
Ah
Ex
aO
Mt
dl
zU
TX
yV
PZ
zU
fN
DX
sx
we
zU
"}
(12,1,1) = {"
zU
JC
Px
zU
Ur
lh
zU
sS
tg
yU
zU
zU
jc
nY
zU
zU
"}
(13,1,1) = {"
zU
zU
zU
zU
lj
zU
zU
zU
zU
lj
zU
QO
br
br
CR
zU
"}
(14,1,1) = {"
yr
pM
br
nb
br
iB
yr
pM
nb
kf
yr
DA
gq
br
pd
zU
"}
(15,1,1) = {"
zU
eS
YF
kv
br
bH
zU
xv
Dc
bH
zU
zU
ag
ag
zU
zU
"}
(16,1,1) = {"
zU
zU
zU
yr
zU
zU
zU
zU
yr
zU
zU
zU
zU
zU
zU
jw
"}
